S.########################################################################################################################################################################################################
..#...#.....#...#...#...#.#.#.#.......#...#.#...#...#.#.......#.......#...#.....#.#...#.#...#.#.....####################################################################################################.G
#.#.#.#.#.#.###.#.#####.#.#.#.#######.#.###.#.#####.#.#.###.###.#####.#.#######.#.###.#.#.#.#.###.#.##...#...#...................#.......#.....#.......#.............#.#.#...#...#.....#...#...#.........#
#...#...#.#.#...#.......#...#.......#.......#.#.#.......#.#...#.....#...#...#.#.......#.#.#.....#.#.##.#.#.#.#.###.###.###.#####.#.#.#######.#####.###############.#.#.#.#.#.#.#.###.###.#####.#######.#.#
#####.#######.###.#########.#.#######.#.#.###.#.#####.#.#.#.#.#.###########.#.###.#####.#.#####.#.#.##.#.#.#.#.#...#.....#.#.......#...........#.....#...........#.#...#.#.#.#.#.#.#.#...............#.#.#
#.#.#...#...#.............#...#...#...#.#.#.......#.#.#.#.#.#.........#...#.#...#.......#.....#...#.####.###.#.#.#######.#.#########.#.#####.###.#.#########.#.#######.#.###.#.###.#.#.###.#######.###.###
#.#.#.#.###.#.#########.#####.#.#.#####.#.###.###.#.#.###.#.#.#.#########.#.###.###.#.###.#########.##...#...#.#.#.#.#...#.#...#.....#.#.......#.#.#...#.....#.............#.....#...#.#.....#.......#...#
#.....#...#.#.#.......#.#...#.#.#...#...#...#...#.#...#.....#.#.#.#.#...#.#.#...#.#.#...........#...##.#.#.#.#.#.#.#.###.#.###.#######.#######.#.###.#.###.#########.#####.###.###.#.#.#####.#########.###
#.#.#######.#.#.#.#####.#.###.###.#####.###.#.#.#.###.###.#####.#.#.###.#.#.#.###.#.#.#####.###.#.#.##.#...#...#...#.....#...#...#.....#.#.......#.#.#...#.#.#.#...#.#.............#.....#.#.#.#.....#...#
#.#...#.....#...#.#...#.......#.......#.#.....#.#.......#...#.#...#.....#...#.#.....#...#.#...#.#.#.######.#.#####.#######.###.#.#####.#.#.#.###.#.#.#####.#.#.###.#################.#####.###.#####.###.#
#.#########.###.#.###.#.#.###.#.###.#########.#############.#.#.#######.###.#.#####.#####.#.#######.##...#.#...#.#.#.#.#.......#.#.......#.#.#.#.......#.#.#.....#.....#...#.....#.#.......#.........#...#
#...#...#.......#.#.....#.#.#...#.#...#...............#.#...#.....#...#.#.......#.#...#...#.#.#.....##.#.#####.#.###.#.#.#.###.#######.#####.#.#.###.###.#######.###.#.#.#.###.###.#.###.#.#.###.#######.#
###.#.#.#.###.###.#.###.###.#.###.###.###.#.#####.#####.#######.###.###.#.###.###.#.#####.#.#.#####.##.#.#.......#.....#.#.#.......#...#.......#...#.....#.#.........#...#.#...#.#.....#.#...#.#.#.#.....#
#.....#.#...#.#...#.#.....#.#.......#.#...#.#.#.#...#.#.#.#.......#...#.....#...........#...#.#.....####.#.###.#####.###########.###########.#######.###.#.#.###.#######.#.###.#.#.###.#####.#.#.#.#.###.#
#.###.#.#.###.###########.#.#######.###.#####.#.#.###.#.#.###.#.#.#.###.#####.###.###.###.#.#.###.#.##.....#...#.........#.......#.#...#...#.#.#.#.#.#...#...#.#.#.....#.#.#.....#...#.....#.#.......#...#
#.#...#.....#.......#...#...#.....#.#.#...#.........#.....#...#.#...........#.#...#.#.#...#.#.....#.####.#####.###.###.#.#########.###.#.#.###.#.#.#####.#.#.#.#.###.#.###.#.###.#.#####.#####.#########.#
###.#.###########.#####.#.#.#.###.###.###.#.#.#####.#.#.#.###.###########.#.#.#####.#.#.#######.###.##.#.....#.#.#...#.#.#.......#.#.#...#.....#.....#...#.#.#.#.#...#.#.#.#.#.....#.#...#.#.....#.....#.#
#...#.#.#...#.#.#...#.....#...#.....#...#.#.#.#.#.....#.#.#.....#.......#.#.#.#.#.#...#...#.#.#.#.#.##.###.#.#.#.###.#########.#.#.#.#.#.#######.#####.#######.#######.#.#.#.###.###.#.###.#.###.###.###.#
#####.#.#.###.#.#######.#########.###.###.#####.#########.#####.###.###.#####.#.#.#########.#.#.#.#.##.....#.#.#...#...#.#...#.#.#.#...#.....#...#...#...#.....#.#.#.........#.......#.#.......#.#...#...#
#...#.#.....#...#.......#.......#.......#.....#.#...#.......#.........#...#...#.............#...#...##.#####.#.#.###.###.#.#####.#.#.###.#####.#.###.#.#.#.#.###.#.#.#.###.###.#######.#.#####.###.#######
#.###.#####.#.#####.###.###.#.#####.#######.###.###.###.###.###.###.#############.#####.###########.##...#...#.......#.....#...#...#.#.#.....#.#...#...#...#...#.....#...#...#.....#.#.#.#.#.....#.#.....#
#...#.#...#.....#...#...#...#.#.#.........#.#...#...#...#...#.#.#...#...#...#.#.#.#.#.#.....#.......##.#.#.###.###.#.#.###.#.#####.#.#.#####.#.#####.#####.###.#.###.###.#######.###.#.###.#####.#.#####.#
#.#####.###.###########.#.###.#.#.###.#######.#####.#####.#.#.#####.#.#####.#.#.###.#.#.#.###.#.######.#.#...#.#...#.#.#...#.......#.......#.........#.......#...#.#...#...#...#...#...#.....#...#.......#
#...#.......#.............#...#...#.#.#...#.........#.#...#...#...#.......#...#.#...#...#...#.#.#...####.#.###.###.#.#####.###.###########.#########.#########.#.#.#.###.###.#.###.#######.###.###.#.#####
#.#####.#####.#########.#######.#.#.#####.#####.#.###.#.#######.#.#.#.#######.#.#.#####.###.#.#.#.####.#.#.#.....#.#.#.#.#.......#.....#...#.........#.........#...#.#...#...#...#.#.......#...#.#.#.#.#.#
#...........#.#...#.........#...#.#.#...#.......#.........#.....#.#.#...#.......#...#...#.#.#.#.#...##.#.#.###########.#.#.#####.#.#####.###.#######.#########.#.#######.#.###.###.#######.#.###.#.###.#.#
#.###.#######.###.#######.#####.#.#.#.#.#.#.###########.#####.###.#####.#.#.#######.###.#.#.#.#.###.##...#.....#.......#.#...#.#.....#.#...#.#...#.#...#...#...#...#...#...#...#.#.........#.#.#.........#
#.#.#.......#...#.........#...#.#...#.#...#.#.......#.....#...#...#...#...#.#.......#.#.#.#...#.....##.#.#########.###.#.###.#.###.###.###.#.#.###.###.#.###########.#####.###.#.#.#####.###.#.#.###.#.###
#.#.#.#####.#.#.#####.###.###.#########.###.#######.#.#.###.#########.###.#.###.#.###.###.###.#####.##.#.....#.....#.#.......#.......#.....#.#...#.....#.#.#.....#.#...#.....#.#.#...#...#.#...#.#.#.#...#
#.#.#.#...#.#.#...#.....#...#.#...........#.........#.#.........#.....#...#.....#...#.#.....#.#.#...######.#.###.###.#####.###.#.#.#.###.###.###.#.#.#.#.#.###.#.#.#.#.#########.###.#####.#.#.###.#.###.#
#.#.#####.#.###.###.#.#######.#.###.#######.#.#.###.#####.###.###.#.#.###.#####.#.###.#.#######.###.##...#.#.#.#.#.#.#...#.#...#.#.#.#...#.....#...#.#...#...#.#...#.#.#.......#.#.#.#.#.#...#.........#.#
#.#.#.....#.......#.#...#...#.#.#.#.#.....#.#.#...#...#...#.#.#...#.#.#.....#...#.......#...#...#...##.#.#####.#.#.#.###.#.#####.###.###########.###.#.#.#.#####.#####.#.#.#####.#.###.#.#####.#.#.#####.#
###.###.#######.#.#######.#.#.###.#####.###.###.#.#####.#.#.#.#.###.#######.#####.#.###.#.#####.#.#.##.#...........#...#.#...#...#.#.#.#.#.....#.#...#.#.........#...#...#.#...#.#.......#...#.#.#.....#.#
#.#.....#...#...#.#...#.#.#...#.#.........#...#.#.#.#.#.#.#...#.#.....#.#...#...#.#.#.#.#...#.#...#.##.#######.#.#.#.###.#.#######.#.#.#.#.#.#####.#########.#.###.#####.#####.#.#.#.#.###.#.#.###.###.###
#.#.#.#.#.#####.###.###.#.#.#.#.#.#######.#.#####.#.#.#.#########.#####.###.###.###.#.#.#.###.#.###.##.......#.#.#.#...#.#.#...#.#.#.#...#.#.#.#.....#.#...#.#.#.#.......#.......#.#.#.....#...#.#...#...#
#...#.#.#.......#.#.......#.#.#.#.....#.#.....#...#.#.........#.......#.#...#.......#.#...#...#.#...##.#####.#.#######.#.#.###.#.#.#.#.###.###.#####.#.#.#######.#####.###.#######.#.###.#.#.#.#.###.###.#
#####.###.#####.#.###.###.#####.#.#####.#.###.#.###.#####.###.###.###.#.###.###.#.###.#######.#####.##.....#.#.....#.....#.#.#.#...#.........#.......#.#.#...#.#...#.#...#.......#.#.#.#.#.#.#.....#.#.#.#
#.#.#.....#.#...#.....#.....#...#...#...#.#...#.......#...#...#.#.#.#...#.....#.#...#.........#...#.##.###.###.###.#.###.#.#.#.#.#.#.###.#######.#####.#.#.#.#.###.#.#.#.#.#####.#####.#.#.#######.#.#.###
#.#.###.###.###.###.#####.###.#####.#.#.#######.###.#####.###.#.#.#.#####.#.###.###.###.#####.#.######.#.#...#.#.....#.#.#...#.#.#.#...#.#.#.....#.#...#...#.#...#.#...#.#...#.......#.#.#.#...#...#.#...#
#.#...#.#...#.....#.#.#.#.#...#.......#.#.#.......#.#...#.#.#...........#.#.#.#...#...#.....#.#...#.####.###.###.#####.###.###.#.#.###.###.###.###.#.#####.###.###.#.#####.#########.#.###.###.#.#####.#.#
#.###.###.#####.###.#.#.#.###.###########.#########.#.#####.#.###.###.#####.#.#.#.#####.#.#####.###.##.....#...#.#.#...#.........#.#.#.#...#.#.#.#.......#.......#...#.....#.....#.....#...#.....#.#...#.#
#.......#.#.#.#.#...#.#.#...........#.#.#.....#.....#...#.#...#.#.#.#...#.....#.#...#.#.#.....#.....####.#######.#.#.###########.###.#.###.#.#.#.#####.#.#######.#.#.###.###.#####.###.#####.###.#.#.#####
###.#.#.#.#.#.#.#.#.#.#.###.###.###.#.#.#.#####.#######.#.#.#.#.#.#.#####.###########.#.#####.#.######...#...#.#.....#.....#.#...#.......#.......#.#.#.#...#.......#...#...#.....#...#.........#.......#.#
#...#.#...........#.....#.....#.#...#.......#.#.....#.......#...#...#.#...#.........#.#.#.#.....#...####.###.#.###.###.#####.#######.#.#.#.#####.#.#.#.#############.###.#.###.#.#.#.#.#.###########.###.#
#.#.###.#.###.#####.#.#####.#######.#####.###.#.#.#############.###.#.#########.#.#.#.###.#.#.#####.##.#.....#...#.#.....#.......#...#.#.#.#...#.....#.......#.#.#.....#.#...#.#...#.#.#.#.#.#.....#.#.#.#
#.#.#...#.#.#.#...#.#.#...#...#.#...#...#.......#.....#.#...#.#...#...#.........#.#...#.#...#.#.....##.###.#####.#.###.#####.#.#####.#####.#.#######.#.#.###.#.#.#.###.#.#.###.#######.###.#.#####.#.#.#.#
#.#.#.#####.#.#.###.#.#.###.#.#.#.#####.###############.#.###.#.#.#####.###.#####.#####.#####.#.#.####.#.#.#...#.......#.#.#.#.....#.#.....#...........#.#.#...#.#.#...#.#...#.#.....#.#...#...#.#.....#.#
#.#.#.#...#.......#.#...#...#...#...#.....#.......#.......#.#.#.#...#...#...#...#.#.#.#.......#.#...##.#.#.#.#######.#.#.#.#.#####.#.#########.#.#######.#.#####.#.#.#.###.#######.#.#####.#.#.#.#.###.#.#
#########.#.#.#####.###.#######.#.#.###.#.###.#.#.###.#.#.#.#.#####.#.#####.###.###.#.###.###.###.####.#.#...#.....#.#.#.....#.#.....#.........#.#.#.............#.#.#.#.....#.....#.....#...#.#.#.#.....#
#...#.....#.#...#.#...#...#.....#.#.#...#.#.#.#.#.#...#.#...#...#.....#...#...#.#.....#...#.........##.#.###.###.#####.#.#.#.#.#.#####.###.#.#.###.#.#.#.###.###.#####.#####.#####.#.#########.#.#####.###
#.#.#.###.###.#.#.#####.#######.###.#####.#.#####.#######.###.#.###.#.#.###.###.###.###.###.#######.##.#...#.......#.#.#.#.#.#.....#.#.#...#.#.#.....#.#...#.#.....#.#...#...#.....#.....#.....#.......#.#
#.#...#.......#.#.#.#.#.#.....#.#.#...#.#.#.....#.#...#.#.....#.#...#...#.....#.....#.....#.......#.##.#.#.###.###.#.#.#####.#######.###.#####.#.#####.#######.###.#.###.#.#.###.###.###.###.###.#######.#
#.#.###.###.#####.#.#.#.#.#.#####.###.#.#.###.#.#.#.###.###.#####.#####.#####.#.#########.#.#####.####...#.....#.#...#.#...#...#.....#.#.#...#.#.#.#.#.#...#.#...#...#.....#...#...#.#.....#...#.........#
#.#.#...#.....#.#.#.....#.#.....#.........#.#.#.............#.#.#.#.....#.....#.....#...#.#.#.#.....##########.#.#.#####.###.#######.#.#.###.#.###.#.#.###.#.#.#.#.#####.#.#####.###.###.#.###.###.###.###
#.#.#.#.#######.#.#.#.#.#####.#.#########.#.#######.#.#####.#.#.#.###.#######.#.#####.#.#.#.#.###.#.##.#.#.#...#.......#.#...#...#...#...#.....#.......#.......#.#.#.#...#...#...#...#.#.#.#.......#.#...#
#.#.#.#...#.......#.#.#.#.....#.#.....#...........#.#.#...#.#.#...#.#...#.#.....#.#...#...#.#.....#.##.#.#.#####.#.#.###.#.#.###.#.#.#.#####.###############.#.###.#.#.#####.###.#####.#####.#####.#.#.###
#.###.#####.#.###.#####.#.#####.#####.#.#######.#.#.###.#.#.#.###.#.#.###.#######.###.#.#####.#.#.#.##.#.#...#.#.#.#...#.#.#...#...#.#...#...#.......#.....#.#...#.#...#...#.........#.#...#.#...#.#.....#
#.#.....#...#.#.....#.......#...#.#.#.#...#.....#.......#.#.#.....#.#...#.#...#.#.#.#.#.#.....#.#.#.##.#.###.#.###.#####.#.#####.#######.#####.###.#.#.#############.###.#.#########.#.#.#.###.#.#.#####.#
###.###.#.###.###.#####.#######.#.#.#.#####.#.#.#.#############.###.#.###.#.#.#.#.#.###########.###.##...#.#...........#.....#.....#.#...#.......#.#.....#.......#...#...#.#...#.........#.#.#.#.....#...#
#...#...#.#.....#.....#.#...#.......#.......#.#.#.#...#.......#...#...#.....#...#.........#.......#.####.#.#.#.#.#.#.#.#.#.#.###.###.###.#.#.#.#####.#######.#.#.#.#.#.#.#####.###########.#.#####.#.#####
###.#######.#.#.###########.###.#.###.#.#.#.#####.#.#######.#.#.###.###.#####.###.#####.###.#.#.######.......#.#.#.#.#...#.#.#...........#.#.#.....#.....#...#.#...#.#.#.#...#.....#.#...#.#.#.....#.....#
#.....#...#.#.#...#.........#.#.#.#...#.#.#.#.......#.......#...#.....#.....#.....#...#.....#.#...#.##.###.###.#####.###.#.#.#.###.###########.#########.#.#####.#.###.###.#####.#.#.#.#####.#.#####.###.#
###.###.###.#####.###.###.#.#.###.###.###.###.#.#####.###.###.#.#####.#########.#.###.###.#.#####.#.##.#...#.#...#.....#.#.#.#.#...#.......#.#.#.......#.#...#.#.#...........#.#.#.#...#...#.....#.#...#.#
#.#.#...#.#.....#.#.#...#.#.#.#...#.#.#.....#.#...#...#.#...#.#...#.#...#.......#.#.#.#...#...#.#...##.#.###.###.###.###.#####.###.#####.#.#.#######.###.#####.###.#.#.#.#####.#.###.###.###.#####.#.#####
#.###.###.###.#.###.#.#.#.#.#.#.###.#######.#####.#.#.#.#.###.#.#.#.#.#####.#####.#.#.#######.#.#.####.#.#.....#.#...#.....#.....#...#...#...#.#...#.......#...#...#.#.#.#...#.....#.#...#.........#...#.#
#.....#.#.....#.....#.#.#.#...#.........#.......#.#.#...#.#...#.#...#.......#.#.#.#.#.#.#.....#.#.#.######.###.#####.#.###.###.#####.#.#####.#.###.#.###.#####.###.###.###.#.###.###.#.###.#######.#####.#
#.#####.#.#######.#.#.###.#.#.#.#.###.###.#####.#.#.#######.#####.###.#######.#.###.#.#.#.#.###.###.##...#.#.#.......#.#.......#.#.#.#.....#.#.....#...#.#.........#.......#.#...#.......#.#...#...#.#...#
#.......#.#.#.#...#.#.#...#.#.#.#...#.#.#.#.....#.#...#.#.#.#.......#.......#.#.#.....#...#.#...#...##.#.#.#.#.#####.###.###.#.#.#.#.#.#######.#.#####.#.#.#.#########.#####.###.###.###.#.#.#.###.#.###.#
#.#######.#.#.#.###.#.#######.#.#.#.#.#.#####.#########.#.###.#####.#####.#.#.#.#.###.#.#.###.###.####.#.....#...#...#.#...#.#.#...#.#.........#...#.#.#.#.#.#.#...#.#.....#.#...#...#.#.#.#.#...#.#...#.#
#.#...........#...#.#...#...#.#.#.#.#.....#.#...#.#.........#...#...#.#...#.#.......#...#.#.#.....#.####.###.#######.#.#######.#.#.###.#####.###.###.#.#####.#.#.#.#.###.#######.#####.#.###.#.#####.#.#.#
#.#.#####.#.#.#.###.#.#####.###.###########.###.#.#.#.#####.#####.#.#.#####.#.###.#.#####.#.#.#####.##.#.#.....#.......#.#...#...#.#.#.#.#.....#.#.#...#...#...#.#.#...#.#.#.....#...#.......#...#...#...#
#...#.#.#.#.#.#.#...#.#...#.#.#.#...#.....#...#.#...#...#.#...#.#.#.......#.#.#.#.#.#...#.........#.##.#.#####.#.###.###.#.#######.#.###.#######.#.#.###.#####.###.###.#.#.###.#####.#.###.#.#######.###.#
#####.#.###.###.#####.###.#.#.#.###.###.###.#.#.#.#.#.###.#.#.#.#.#########.###.#####.#.#.###.#.###.##.#.#.#...#.#.#...#.....#...#.#...........#.........#.#.........#.....#...#.....#...#.#.....#.#.#...#
#.#.....#.....#.#.......#.......#.....#.#...#.....#.#.#.....#.#...#.....#.#.#...#...#.#...#.#.#.#...##.#.#.#####.#.#.#####.###.###.#########.###.#######.#.#.###.#########.###.#.###.#.###.###.###.#####.#
#.#.#########.###.#.###.#.###.###.###.#.#.###.###.#.###########.#####.###.#.#.#####.###.#.#.###.#.####.#.#.......#...#.........#...#.#...#.#...#.#.......#.....#...#...#...#...#.#.......#.#.#.#...#.....#
#...#.....#.......#.#...#.#.....#.#...#.#...#.#...#...#...#...#...#...#...#.#.........#.#.#.........##.###.#######.###.#######.#####.#.#.#.#.#.#.###########.#####.###.#####.#.#.#######.###.#.#.#.#.###.#
#.#.#.###########.#.#.#####.#.#####.###.#######.#########.#.#######.#.###.###.#######.#.###.#.###.#.##...........#.#...#.........#...#.#.#...#.......#.........#.....#.#.#...#.......#...#...#.#.#.#.#...#
#.#.#.#.....#.#.#.#.#.......#.....#...#.........#.........#...#.#...#...#...#.#.......#...#.#.#.#.#.##.#####.#####.#########.#######.#.#.#####.#####.#.###.#.#######.#.#.#.#######.#.#.#####.###.#.#.#.###
###.#.###.###.#.#####.###.###########.#########.#########.#.#.#.###.###.#.###.#######.###.###.#.######...#.......#.............#...#...#.#.#...#.........#.#...#...#...#.......#...#.#...#...#...#.#.#...#
#.#.#...#.#...#.#.#...#.......#.......#.........#.......#...#.#...#...#...#...#...#.....#...#.......##.#####.###.###########.#.###.#.#.###.#######.#####.#####.#.#.#####.#.#####.#.#.###.#.#.#.###.#.#####
#.#.#.###.###.#.#.###.#.#####.#.#.#####.#.#####.#####.###.#.###.###.#######.###.#.###.#####.#.#####.##...#.#...#.....#...#...#...#.#.#.........#.#...#...#...#...#.#.#...#...#...#.#.#.#.#.#.....#.......#
#...#...#.......#.....#...#...#.#.#.....#.#...#...#...#...#.....#...#...#.....#.#.#.#.#.....#.#.....##.###.#####.#.#####.###.###.#.#####.#######.###.###.###.###.###.###.#############.#####.###########.#
#.#####.#.#.###.###.#.#####.#.#.###.#####.#.###.#.#.#.#.###.#.#.#.###.###.#######.#.#####.###.########...#.#.....#...#.......#.......#.......#.....#.#...#.......#.........#...#...#.............#...#...#
#.....#.#.#...#...#.#...#.#.#.#...#.....#...#...#...#.....#.#.#.........#.......#.#.......#.#...#...######.#.#.###.#.#######.#########.###.###.#####.#########.#####.###.###.#####.#.#.#########.#.#.#.#.#
#.###.#.#.#.###.#########.#.#.#.#.#.#######.#####.#######.#######.#.#.#.###.###.#.###.#.###.###.###.##...#.#.#...#.#.#...#.....#...#.....#...#.#.#.#.#.....#.#.#.....#.......#.#.#.#.#.#...#...#.#.#.#.#.#
#.#.....#.#.#...#.#.#.......#.#.#...#.....#.....#...#.#.#.#.#...#.#.#.#.#.....#.#...#.#.....#.....#.####.#.###########.#####.#.#.#.###.###.###.#.#.#####.#.#.#.###.###########.#.#.#####.#.#.#######.###.#
###.#####.###.###.#.#########.###.#.#.###.#.#.#####.#.#.#.#.###.#.###.#.###.#.#####.#####.#########.##.#...#.....#.......#...#...#.....#.#.#...#.........#.....#...#.#...........#.#...#.#.#...#.#.....#.#
#.....#...#.........#.......#.#...#...#.#.#.#.#.#...#...#.#.#.....#.#.#.....#...#.....#.#.......#...##.###.#.#.###.###########.#.#######.###.#####.#.#.###.#.#.###.#.#.#.###.#####.###.###.###.#.#.###.#.#
###.#.###.#####.###########.###########.#######.###.#.#.###.#######.#.###.#.#.###.#####.#.#.#.#.###.##.....#.#...#.#...#.#.....#.#.......#.#...#.#.#.#...#.#.#.#.......#...#.....#...........#...#.#.....#
#.#.#.......#.....#.#.#.......#...#.......#...#.....#.#.........#...#.#...#.#.....#.#...#.#.#.#.....####.#.#.#.###.###.#.###.###.#.###.###.###.#.#####.#####.#######.###.###.#.###.###.#.#####.#.#.#####.#
#.#.#####.#.###.#.#.#.###.#######.#####.#.#.###.###.#######.###.#.#.#.###.###.#.###.#.#.###.#######.##...#...#.......#.#.....#.#.#...#.#...#...............#.#...#.....#...#.#.......#.#...#...#.#.#.....#
#...#.#...#.#.#.#.#.......#.#.......#.#.#.#.......#.#.#.....#.....#...#.....#.#.......#.........#...##.#########.###.#.###.#.#.###.#.###.#########.#############.#.#.#######.###.#.#####.#####.#.#######.#
#####.#.#####.#######.###.#.#####.#.#.#.###.#.#.#####.#.#.###.#################.#####.###.#####.###.##.#...#.....#...#.#...#.......#.......#.#.....#.#.......#...#.#...#.....#...#.#.....#...#.#...#.#.#.#
#.#...#...#...#.....#...#...#.....#.#.......#.#.#...#.#.#.#...#.#.............#.....#.#.#.#.....#...##.#.#######.#.#.#.#####.#.###.###.#####.###.#.#.#.###.###.#####.#.#.###.#.#.#.###.#.#.#####.###.#.#.#
#.#.#.#.#.#.#.#.###.#.###.#######.#######.#.###.#.###.#########.#####.###.###.#.#.#####.#########.####.....#...#.#.#.......#.#...#.#.#...#...#...#...#.#...#.....#.#.#.#.#...#.#.#...#.#.#...........#...#
#...#...#.#.#.#.#...#.#...#.....#.#.......#.#.#...#.....#.............#.....#...#.#.....#.......#...##.#.#.#.###.#.#########.#####.#.#.#####.#.###.###.#.#.###.#.#.#.#########.#.###.###.#.###.#########.#
###.###.#.#.#######.#.#########.#.#####.###.#.#########.#.#######.#.###.#.###.#.#.###.#######.###.####.#.#...#...#.............#...#...#...#.#.#.......#.#.#.#.#.#.........#...#.#...#.......#.....#...#.#
#.#.#.#.#.#...#.....#.#.......#...........#.....#...........#.#...#.#.#.#.#.#.#.#...............#.#.######.#######.###.#########.#.#######.#.#.###.#.#####.#.#.#.#.#.###########.#.###.#####.#.#####.#.#.#
#.#.#.#.#.###.###.###.#####.#.#.#######.#####.###############.#.#.#.#.#.#.#.###.###.#####.#######.#.##...#...#.#.#...#.......#...#.......#.......#.#.#.......#.#...#.....#...#...#.#.......#.#.#.....#.#.#
#...#...#...................#.......#.....#.......#.............#.#.#...#...#.....#...#...#.........##.#.#.#.#.#.###.#.#####.#.#.#.#######.#.###.#.#####.#.#.###.###.#####.#.#######.#.###.#.#.#.#.###.#.#
###################################################################################################......................................................................................................#