..#####S#############
........#.#.#...#.#.#
#.#.#.###.#.###.#.#.#
#.#.#.#.#...#.#.....#
#.#####.#.###.#####.#
#.#.#.#...#...#.....#
#.#.#.###.###.#.#.###
#.#.............#...#
#.###.#.#####.###.###
#.#...#...#...#.#.#.#
#.#.#########.#.###.#
#.....#.............#
#.#####.#######.###.#
#...#...#.....#.#...#
#.###.#####.###.###.#
#.#...#.#...#...#.#.#
#####.#.###.###.#.#.#
#.......#.#.#.#.#.#.#
#.#.###.#.#.#.#.#.#..
#.#...#.....#.....#G.
###################..