###############S###
#.................#
#.#################
#.............#...#
#.###.#####.#.#.#.#
#...#.#...#.#.#.#.#
#.#.#.###.#.#.#.#.#
#.#.#.....#.#...#.#
###########G#######