S.#######################################
..#.#.....#.....#...#...#...#...........#
#.#.###.###.#.###.#.###.#.###.#.###.#####
#.......#.#.#...#.#.....#.#...#...#.#...#
#######.#.#####.###.###.#.#.#.###.#####.#
#.........#.#.....#.#.......#...#.#...#.#
#.###.#####.###.#####.#####.#####.#.###.#
#.#.....#.#.#.#...#...#...#.#.#...#.....#
###.#####.#.#.#.#.#.#####.###.###.#.#.###
#.......#...#.#.#...............#...#...#
#####.#####.#.#######.###.#.#######.###.#
#...........#.......#.#.#.#.#.........#.#
#.#########.#######.###.#####.###.###.#.#
#.#.#.........#.......#.....#...#.#...#.#
#.#.#####.#.#.#.###.#.###.#########.#.###
#.....#...#.#...#.#.#...#...#...#...#...#
###.#.#######.###.#.###.#.###.#.#.###.#.#
#...#.#.#...#.#.......#...#.#.#.#...#.#.#
###.#.#.#.#.#.###.###.#####.#.#####.#####
#...#...#.#.#...#...#.#.........#.....#.#
###########.###.#.#####.###.#####.#.###.#
#...#.#.#.......#.#.#...#.........#.....#
#.#.#.#.###.#.###.#.#####.#.#####.#.###.#
#.#...#.#...#.#.#...#...#.#.#...#.#.#...#
###.#.#.#######.###.###.#####.#.#.#.###.#
#...#.....#.#...#.....#.....#.#...#.#.#.#
###.#######.###.###.#######.#.#.#.###.#.#
#.....#.#.....#.......#.#.#...#.#.#.....#
#.#####.#.#.#.###.#.#.#.#.#.###.#######.#
#...#.....#.#.....#.#.#.#...#...#.#...#.#
#.#.###.#######.#####.#.#.#######.###.#.#
#.#.....#...#...#...#.#.......#...#.#.#.#
###.#####.#####.#.#.#.###########.#.#.#.#
#.....#.#.......#.#.........#.......#...#
#.###.#.#####.#.###########.#.#########.#
#...#.#.#...#.#.#.......#.....#.#.......#
###.###.#.#.#######.#.#.###.#.#.###.###.#
#...#.#...#.#.#.....#.#.#.#.#.#...#.#.#.#
#.###.#.#.#.#.#.#.#######.#.#.#.###.#.###
#.....#.#.#.....#...........#...........#
#######################################.G