..###############################################################################
..#...#.#.#.#...#...#.....#.#.#.....#.#.....#.....#.#...#.....#...#.........#...#
#.#.#.#.#.#S#.#.#.#####.###.#.#.#.###.#.#.#.#.#####.#.###.#######.#######.#.###.#
#...#.#.......#.#.....#.........#.#.#.#.#.#.....#.#...#.#...............#.#.#.#.#
#.#####.#.#.###.###.#.#.#######.#.#.#.#.###.#####.#.###.###.#####.###.#.#.###.#.#
#.......#.#.#.......#.....#.#...#.........#.........#.....#.#.......#.#...#...#.#
###.#####.#.#####.#.#.###.#.###.#.#.###.#########.#.#####.###.###.###.#.#####.#.#
#...#.....#...#...#.#.#...#.....#.#.#.....#.......#.............#...#.#.G........
###############################################################################.#