..##########
...........#
#.#####.#.##
#..S#G..#...
#########.##