..#######################################
.S#.#.........#.#.......#.#.....#.#...#.#
#.#.#####.###.#.###.#####.###.#.#.#.#.#.#
#...........#.................#.....#.G..
#######################################.#