..###
..G.#
#.###
#.S.#
#.###
#...#
#..##
#...#
##..#
#...#
#.#.#
#...#
#.#.#
#.#.#
#.###
#.#.#
#.#.#
#.#.#
#.#.#
#...#
###..
